11111111
11 10N01
11110001
11111111