1111111111111111111111111111111
1111010100000000001000000000001
1111000000000000000011100000001
1000000000010000001000001000001
10000100000000010000N0001000001
1000000010000000001000000000001
1000000100000001000000010000001
1000000000100000000010000001001
1000000010000000000100000010001
1000000000000000000000000000001
1111111111111111111111111111111